houston	city_name
coach	class_type
cincinnati	city_name
departure-times	flight_time
round-trips	round_trip
four	day_number
6pm	start_time	time
milwaukee	city_name
atlanta	city_name
before	time_relative
5pm	time
twenty-seventh	day_number
la	city_name
denver	city_name
819	time
8	time
midwest	airline_name
twentieth	day_number
evening	period_of_day
return	return
around	time_relative
dc	state_code
new-york	city_name
early	period_mod
vegas	city_name
3pm	time
day	date_relative
10pm	end_time
miami	city_name
least-expensive	cost_relative
wednesday	day_name
detroit	city_name
morning	period_of_day
417	flight_number
united-airlines	airline_name
meal	meal
qo	fare_basis_code
rental-car	transport_type
orlando	city_name
one-way	round_trip
second	day_number
cleveland	city_name
first-class	class_type
saturday	day_name
phoenix	city_name
chicago	city_name
noon	start_time	time
tomorrow	today_relative
newark	city_name
kansas-city	city_name
los-angeles	city_name
fort-worth	city_name
after	time_relative
august	month_name
st.-petersburg	city_name
sixth	day_number
friday	day_name
no-stops	flight_stop
round-trip	round_trip
earliest	flight_mod
2pm	end_time
8pm	time
denver-airport	airport_name
las-vegas	city_name
april	month_name
afternoon	period_of_day
baltimore	city_name
first	day_number	flight_mod
delta-airline	airline_name
washington	city_name
nonstops	flight_stop
thursday	day_name
oakland	city_name
westchester-county	city_name
twa	airline_code
philadelphia	city_name
next	date_relative
continental	airline_name
december	month_name
pittsburgh	city_name
georgia	state_name
delta	airline_name
july	month_name
memphis	city_name
tampa	city_name
toronto	city_name
dallas-fort-worth	city_name
cheapest	cost_relative
727	aircraft_code
charlotte	city_name
northwest-airlines	airline_name
747	aircraft_code
boston	city_name
dl	airline_code
san-francisco	city_name
seattle	city_name
delta-airlines	airline_name
salt-lake-city	city_name
united	airline_name
dallas	city_name
sunday	day_name
fourth	day_number
nonstop	flight_stop
economy	economy
indianapolis	city_name
monday	day_name
early-morning	period_of_day
may	month_name
american-airlines	airline_name
june	month_name
eighth	day_number
7am	time
5-o'clock-pm	time
twenty-ninth	day_number
daily	flight_days
5-o'clock	end_time	time
nineteenth	day_number
latest	flight_mod
